FileVersion,1
Sprites,64
Colorselector,0,0,0,0
Colorselector,1,16,16,16
Colorselector,2,32,32,32
Colorselector,3,48,48,48
Colorselector,4,64,64,64
Colorselector,5,80,80,80
Colorselector,6,96,96,96
Colorselector,7,112,112,112
Colorselector,8,0,255,0
Colorselector,9,0,128,255
Colorselector,10,160,160,160
Colorselector,11,176,176,176
Colorselector,12,192,192,192
Colorselector,13,64,128,128
Colorselector,14,224,224,224
Colorselector,15,240,240,240
Colorselector,16,255,0,255
spritebank,0
SpriteStart
SpriteBitmapBlock,0,16,24
0,0,0,9,9,0,13,13,13,0,0,13,0,0,9,13,13,0,13,0,9,9,0,0
9,0,13,0,0,13,13,0,0,13,13,0,13,13,0,13,0,13,13,13,0,0,13,0
0,13,0,8,8,0,0,8,8,0,0,8,0,0,8,0,8,0,13,0,8,8,0,13
13,0,8,0,0,0,0,8,0,8,0,8,0,8,0,8,0,8,0,8,0,0,13,0
13,0,8,0,8,8,0,8,8,0,0,8,0,8,0,0,0,8,0,8,8,0,13,0
13,0,8,0,0,8,0,8,0,8,0,8,0,8,0,13,0,8,0,8,0,0,13,0
0,13,0,8,8,0,0,8,0,8,0,8,0,8,0,13,0,8,0,0,8,8,0,13
13,0,13,0,0,13,0,0,0,0,13,0,13,0,13,0,13,0,13,13,0,0,13,0
0,13,13,13,13,0,8,8,8,0,0,8,0,13,0,8,0,13,13,13,13,13,13,9
0,9,13,9,13,13,0,0,8,0,8,0,8,0,8,0,8,0,13,13,9,13,9,0
0,0,9,13,13,13,0,8,0,13,0,8,0,0,8,0,8,0,13,13,13,9,13,0
9,13,13,13,13,0,8,0,13,0,8,0,8,0,8,0,8,0,13,13,9,0,13,9
0,9,0,13,13,0,8,8,8,0,0,8,0,13,0,8,0,13,13,13,13,0,0,0
0,0,9,0,13,13,0,0,0,13,13,0,13,13,13,0,13,13,13,0,9,13,9,0
0,0,0,13,9,13,13,13,13,0,0,13,0,13,9,13,13,9,13,0,0,0,9,0
0,0,9,0,9,0,0,9,0,0,0,0,13,0,0,0,9,0,0,9,0,0,0,0
SpriteSpeccyBlock,0,2,3
7,0,0,7,0,0,7,0,0
7,0,0,7,0,0,7,0,0
SpriteAttribs,0,0,0,0
SpriteDataOffSet,&180
eof
